*Buying and selling*
Afford: permitirse
Bargain: chollo, ganga
Cash: dinero en efectivo
Change: cambio
Discount: descuento
Receipt: tiquet
Refund: devolución
Sale: rebajas
Value for money: valor por dinero, buena relación calidad/precio
Waste: desperdicio

*Money and banking*
ATM/Cashpoint: cajero automático
Charges/fees: cuota, pago
Bill: factura
Current account: cuenta corriente
Get into debt: deber dinero
Interest: intereses
Lend money/give somebody a loan: prestar dinero
Overdraft: números rojos
Savings account: cuenta de ahorros
Withdraw money: sacar dinero

*Pharsal verbs connected with money and shopping*
Come to: total
Cut back: reducir el gasto
Get by: suficiente para vivir
Pay back: devolver dinero
Pick up: comprar
Sell out: agotado (no más productos)
Set aside: ahorrar dinero
Splash out: tirar la casa por la ventana