*Parts of the body*
Ankle: tobillo
Bone: hueso
Brain: cerebro
Chest: pecho
Chin: barbilla
Forehead: frente
Heart: corazón
Heel: tacón
Hip: cadera
Kidney: riñón
Liver: hígado
Lungs: pulmones
Skin: piel
Thigh: muslo
Throat: garganta
Toe: dedo del pie
Tongue: lengua
Veins: venas
Arteries: arterias
Wrist: muñeca

*Words connected with health*
Be/become addicted to: ser/empezar a ser adicto a
Be allergic to: ser alérgico a
Be in danger of: estar en peligro de
Be/become obese: ser/empezar a ser obeso
Be painful: ser doloroso
Break: romper
Dislocate: dislocar
Eat fatty food/food high in salt: comer comida alta en grasa/sal
Feel dizzy: sentirse mareado
Fracture: fractura
Get/catch an infection: coger una infección
Get/give a prescription: tomar/dar una receta médica
Get over an illness: superar una enfermedad
Go for a check-up: ir a un chequeo
Have a balanced diet:tener una dieta balanceada
Have/give an injection: recibir/dar una inyección
Have an operation: tener una operación
Have a temperature: tener una temperatura (fiebre)
Increase the risk of: incrementar el riesgo de 
Injure yourself: hacerse daño
Put on/lose weight: ganar/perder peso
Relieve symptoms: aliviar síntomas
Shiver: temblar
Sprain your wrist/ankle: torcerse la muñeca/tobillo
Suffer from heart disease: sufrir una enfermedad del corazón
Take your blood pressure: tomar tu presión sanguínea
Treat somebody for: tratar a alguien
Twist your ankle: torcerse un tobillo
Work out: ejercitarse

*Idioms connected with health and illness*
Be back on your feet: recuperarse de una enfermedad
Be/feel on the top of the world: sentirse bien
Be/feel under the weather: sentirse mal
Black out: perder el conocimiento
Come down with: coger una enfermedad
Keep in shape: mantenerse bien
Pull through: recuperarse de una enfermedad o lesión (similar "be back on your feet", aunque suele ser más serio)